

NO textures/test/north.xpm
SO textures/test/south.xpm 
C 200,200,200
WE textures/test/west.xpm
EA textures/test/east.xpm
WE 
F 20,20,20

111
1N1
11111111111111111111111111111111
10000000000000000000000000000001
10001111100111111111100111110001
10001000000000000000000000010001     11111111
10000000101010101010101000000001     10010001
10000000000000000000000000000001     10000001
100000110001111111111100110000011111110000101
100000100000000000000000010000000000000010001
100000000000000000000000000000000000000000001
100000000000111111110000000000011111110010001
1000001000001      1000010000001     10000101
1000001000001      1000001000001     10000001   11111
10000000000011111111000000000001     11100111   10001
10000000000000000000000000000001       1001     11111
10000010000000000000000001000001       1001
10000011000111111111110011000001       1001
10000000000000000000000000000001       1001
10000000101010101010101000000001       1001
10001000000000000000000000010001       1001
10001111100111111111100111110001       1001
10000000000000000000000000000001       1001
11111111111111001111111111111111       1001
             1001                      1001   
             1001                      1001
             1001                      1001
             100111111111111111111111111001
             100000000000000000000000000001
             111111111111111111111111111111
              11011
              11111

